111111111111111111111111111111111111111111111111111111111111111111111111111111
11DDDDDDDDDDDDDDDDDDDDDDDDDDDDDDDDDDDDDDDDDDDDDDDDDDDDDDDDDDDDDDDDDDDDDDDDDD11
11DDDDDDDDVVVVVVVVVVVDDDDDDDDDVVVVVDDDDDVVVVVVVVDDDDVVVDDDDDDDDDDDDDDVVVVPDD11
11DDDDDDDDVVDDVVVDDVVVDDDDDDVVVDDDVVVDDVVDDDDDDVVDDDDVVVVVVVVVVVVVVVVVDDDDDD11
11DDDDDDDDVVDDDDDDDDVVVVVVVVVDDDDDVVVVVVDDDDDDDDVVVVVVVDDDDDDDDDDDDDDDDDDDDD11
11DDDDDDDVVVVVDDDDDDDDDDDDDDDDDDVVVVDDDDDDDVVVVDDDDDDDDDDDCVVVVVVVVCDDDDDVCD11
11DDDDDDDVVVDVVDDDDDDDDDDDDDDDDDVVDDDDDDDDVVDDVVCDDDDDDDDDDDDVVDDDDDDDDVVVDD11
11DDDDDDDVVVDDVVDDDDDRVDDDDDDDDDVVDDDDDDDVVVDDDDDDDDDDDDDDDDDVVVDDDDVVVVDDDD11
11DDDDDVVVVDDDDVVDDDDDVVDDDDDDDDCDDDDDDDDVVVVVVVVVDDDDDDDDDDDVVVVVVVVVVVDDDD11
11DDDVVVDDDDDDDDCDDDDDDVVDDDDDDDDDDVVVVVVVVDDDDDVVVVVVVVVVVVVVDDDDDDDDDDDDDD11
11DDDVVDDDDDVRDDDDDDDDDVVVDDDDDDVVVVDDDDDDDDDDDDDVVDDDDDDDDVMDDDDDDDDVEDDDDD11
11DDDVVVDDDVVDDDVKDDDVVVVVVVVVVVVVDDDDDDDVVVVDDDDDVVVDDDDDDDVVVDDDDDDVVVDDDD11
11DDDDVVVDDVDDDVVDDDVVVVVDDDDDVVVDDDDDDVVVDDVVDDDDVVVDDDDDDDDVVVDDDDDVVVDDDD11
11DDDDDVVVVVDDDVDDDVVVDDDDDDDDDVVDDDDDVVDDDDVVDDDDDVVVDDDDDDDDVVVXVVVVDDDDDD11
11DDDDDDDVVDDDDVVDDDVVVDDDDVVVVVVVDDDDRDDDVVVDDDDDDDVVDDDDDDDDDDDDDDDDDDDDDD11
11DDDDDDDDVVDDDDVDDDVVVDDVVVVDDDDDDDDDDDDVVDDDDDDDDDDVVVDDDDDDDDDDDDDDDDDDDD11
11DDDDDDDDDVVDDDVVVVVVDDDDVVDDDDDDDDDDDVVVVVDDDDDDDDDDVVDDDDVVVVVDDDDDDDDDDD11
11DDDDDDDDDDVVVVVVDDDDDDDVVVVVVVVVVVVVVVVVVVVVVVVVVVVVVVVVVVVVDDVVDDDDDDDDDD11
11DDDDDDDDDDDDDDDDDDDDDDDDDDDDDDVVVVDDDDDDDDDDDDDDDVVVDDDDDDVVDDDVVDDDDDDDDD11
11DDDDDDDDDDDDDDDDDDDDDDDDDDDDDDDDVVVVVVVVVVVVVVVVVVDDDDDDDDDDDCVVDDDDDDDDDD11
11DDDDDDDDDDDDDDDDDDDDDDDDDDDDDDDDDDDDDDDDDDDDDDDDDDDDDDDDDDDDDDDDDDDDDDDDDD11
111111111111111111111111111111111111111111111111111111111111111111111111111111