111111111111111111111111111111111111111111111111111111111111111111111111111111
11WWWWWWWWWWWWWWWWWWWWWWWWWWWWWWWWWWWWWWWWWWWWWWWWWWWWWWWWWWWWWWWWWWWWTTTTWW11
11WWPCWWWWWWWAAAAAAAAAAAAAAAAAAWWWWWWWWATTTTWWWWWTWWWWWWTWWWWWWWWWWWTTTCATTW11
11WWAAAAAAAAAAAWWWWWWTTTTTTTTWAAWWWWWWWATTTATWWWWWWWWWWTTTWWWTTWWWWWTTTTATTW11
11WWTWTTWWWWWWWWWWWWWWTTTTTTWWWAAAWWWWTTTAATTWWWWWWWWAAAAAAAAAATWWWTTTTWAATW11
11TTWTWTTTWWWWWWTTTWWWWWTTTWWWWWAAAWWWWTTTTTWWWWWWAAAAWWWWWWWAAWWWWWTTAAATTW11
11WTTTWEWWWWWWTTTWWWWWWWWWWWTTTWWWAAAWWWWWWWWWWWAAAWTTTTWWAAAAAWWWWTTWAAWWTW11
11TTWWWAAWWWWWWWWWWWWWAAAAAWWWTTTWWWAAAAAAAAAAAAAAWWTTTTWAAAAAAWWWWWTWWAAWWW11
11TTTTWAAWWWWWWWWWWAAAAWWWAAWWWTTTTWWWTTTWWTTTWWWWTTTWWWWWWAAAWWWWWWTTAAAAAW11
11TWTWWAATWWWTWWWWAAAAWWWWTAAAAWWWWTTTTTTTTTTWWWWWTTAAAAAAAAAAAWWWWWWTTTAAWW11
11WTTWWAATTWWWWWWWWAAWWWWWWWAAAAWWWWWWTWWWTTWWWWWAATAATTAAWWWWWWWWAAAATTAAWW11
11TWTWWAATTWWWWWWWAAWWWTWWWWWWAAAAAAAAAAAAAAAAAAAAAAATTAAATTWWWWRAATWAATTAWW11
11WTTTWAAATWWWWAAAAAWWWWWWWWWWWWWWWWWWAAAAAAWWWWWWWWWTAAAWWTTTWWWWTTWWATTAWW11
11WTTTTTAAAXAAAAAAAAWWWWTTTTTTTTWWWWWWWWAWWWWWWWTTTWWTAAWWWAAAAAWWWWWWAAAAWW11
11TTWTTTWWWWWWWAAAAAWWWWWWTTWWWWWWWWWWWWAWWWWWTTTTTWWTAAWWAATTAAAWWWWWWAAWWW11
11WWWTTTWWWWWWWWWAWWWWTWWWWWWWWWWTTWWWWWAAWWWTTTTWTWWTAAWWTAATTAATTTAAAAAAWW11
11WTTWTTTTTWWWWWWAAAWWWWTTTWWWWWWWAAAAAWWAAWWWWTWTTWWWWAAAAATTAAATTAAATWWWWW11
11WWWWWTTTWWWWWWWWWAAAAWWWWWWAAAAAAWWWAAAAWWWWWWTWTTWWWWWWWWTTAATTAAAATWWWWW11
11WWWWWTTTTWWWWWWWWWWWAAAAAAAAWWWWWWTTWWAWWWWWWWTTWTTTWWWWWTAAATTTAATTWWWWWW11
11WWWWWWWWTTTWTTTTWWWWWWTTTWWWWWWTTTTTWWAAACWWWTTTWWWWTTWWWWTAAAAAATTWWWWWWW11
11WWWTWWWWWTTTTTWTTWWWWWWTWWWWTTTTTTTWWWWWWWWWWWWWWWWWWWWWWWWWWWWWWWWWWWWWWW11
111111111111111111111111111111111111111111111111111111111111111111111111111111
