111111111111111111111111111111111111111111111111111111111111111111111111111111
11SSSSSSSSSSSSSSSSSSSSSSSSSSSSSSSSSSSSSSSSSSSSSSSSSSSSSSSSSSSSSSSSSSSSSSSSSS11
11SSSSSSSSGGGGGGGGGGGSSSSSSSSSGGGGGSSSSSGGGGGGGGSSSSGGGSSSSSSSSSSSSSSGGGGPSS11
11SSSSSSSSGGSSGGGSSGGGSSSSSSGGGSSSGGGSSGGSSSSSSGGSSSSGGGGGGGGGGGGGGGGGSSSSSS11
11SSSSSSSSGGSSSSSSSSGGGGGGGGGSSSSSGGGGGGSSSSSSSSGGGGGGGSSSSSSSSSSSSSSSSSSSSS11
11SSSSSSSGGGGGSSSSSSSSSSSSSSSSSSGGGGSSSSSSSGGGGSSSSSSSSSSSCGGGGGGGGCSSSSSGCS11
11SSSSSSSGGGSGGSSSSSSSSSSSSSSSSSGGSSSSSSSSGGSSGGCSSSSSSSSSSSSGGSSSSSSSSGGGSS11
11SSSSSSSGGGSSGGSSSSSRGSSSSSSSSSGGSSSSSSSGGGSSSSSSSSSSSSSSSSSGGGSSSSGGGGSSSS11
11SSSSSGGGGSSSSGGSSSSSGGSSSSSSSSCSSSSSSSSGGGGGGGGGSSSSSSSSSSSGGGGGGGGGGGSSSS11
11SSSGGGSSSSSSSSCSSSSSSGGSSSSSSSSSSGGGGGGGGSSSSSGGGGGGGGGGGGGGSSSSSSSSSSSSSS11
11SSSGGSSSSSGRSSSSSSSSSGGGSSSSSSGGGGSSSSSSSSSSSSSGGSSSSSSSSGGSSSSSSSSGESSSSS11
11SSSGGGSSSGGSSSGCSSSGGGGGGGGGGGGGSSSSSSSGGGGSSSSSGGGSSSSSSSGGGSSSSSSGGGSSSS11
11SSSSGGGSSGSSSGGSSSGGGGGSSSSSGGGSSSSSSGGGSSGGSSSSGGGSSSSSSSSGGGSSSSSGGGSSSS11
11SSSSSGGGGGSSSGSSSGGGSSSSSSSSSGGSSSSSGGSSSSGGSSSSSGGGSSSSSSSSGGGXGGGGSSSSSS11
11SSSSSSSGGSSSSGGSSSGGGSSSSGGGGGGGSSSSRSSSGGGSSSSSSSGGSSSSSSSSSSSSSSSSSSSSSS11
11SSSSSSSSGGSSSSGSSSGGGSSGGGGSSSSSSSSSSSSGGSSSSSSSSSSGGGSSSSSSSSSSSSSSSSSSSS11
11SSSSSSSSSGGSSSGGGGGGSSSSGGSSSSSSSSSSSGGGGGSSSSSSSSSSGGSSSSGGGGGSSSSSSSSSSS11
11SSSSSSSSSSGGGGGGSSSSSSSGGGGGGGGGGGGGGGGGGGGGGGGGGGGGGGGGGGGGSSGGSSSSSSSSSS11
11SSSSSSSSSSSSSSSSSSSSSSSSSSSSSSGGGGSSSSSSSSSSSSSSSGGGSSSSSSGGSSSGGSSSSSSSSS11
11SSSSSSSSSSSSSSSSSSSSSSSSSSSSSSSSGGGGGGGGGGGGGGGGGGSSSSSSSSSSSCGGSSSSSSSSSS11
11SSSSSSSSSSSSSSSSSSSSSSSSSSSSSSSSSSSSSSSSSSSSSSSSSSSSSSSSSSSSSSSSSSSSSSSSSS11
111111111111111111111111111111111111111111111111111111111111111111111111111111