111111111111111111111111111111111111111111111111111111111111111111111111111111
11ZZZZZZZZZZZZZZZZZZZZZZZZZZZZZZZZZZZZZZZZZZZZZZZZZZZZZZZZZZZZZZZZZZZZZZZZZZ11
11ZZZZZZZVVVVVVVVVVZZZZVVVVVZZZZZZZZZZZVVVVVVVZZZZZZZZZZZZZZZVVVVVVVVVZZZZZZ11
11ZZZZZVVVVZZZZZZVVVZZVVZZZVVZZVVVVZZZVVVZZZVVVZZZZZRVVZZZZZVVVZZZZZVVVVVZZZ11
11ZZZCVVVZZZVVVZZZZVVVVZZZZZVVVVZVVZZVVZZZZZZZVVZZZZZZVVZZZZZVVVZZZZZZZVVZZZ11
11ZZZZZVVVVVVZVVCZZZZVVVZZZZZZZZZZVVVVZZZVVVVVVVZZVVVVVZZZZZZZVVVZZZZZZVVZZZ11
11ZZZZVVVZZZZZZZZZZZZZZVVVVZZZZZZZZZZZZZZZCZZVVVVVVZZVVZZVVVVZVVZZZZZZZZVZZZ11
11ZZKVVVZZZZZZZZZZZZZZZZZVVVZZZZZZZZZZZZZZZZZZZZZZZZZVVVVVZZVVVZZZZZZZVVVZZZ11
11ZZZZZZZZZZZZZZZVVVZZZZZZZCZZZVVVVVZZVVVVVZZVVVVZZVVVVVZZZZZZZZZZZZZVVZZZZZ11
11ZZZZZZRVVVZZZZZVVVZZZZZZZZZZVVVZZVVVVZZVVVVVZZVVVVZZVVVVZZZZZZZZZZZZVVVZZZ11
11ZZZZZZZZZVVZZZZVVVVVVVZZZZZVVVZZZZZVZZZZZVVVZZZZZZZZVVVZZZZZZVVVVVVZZVVZZZ11
11ZZZZZZZZZZVVZZVVZZZVVVZZZZVVVZZZZZZVVZZZZZVVVVVVZZZVVVZZZZZZVVVZZVVVVVZZZZ11
11ZZZZZZZZZZZVVVVZZZZZVVZZZZVVVZZZZZZVVVZZZZZZZVVVVVVVVVZZZZZZVVZZZZZZZZZZZZ11
11ZZZZZZZZZZZZVVZZZZZZVVVVVVVVZZCZZZZZVVVZZZCZZZZZZVVZZZZZZZZZVVVZZZZZZPZZZZ11
11ZZZZZZZZZVVVVVZZZZZZZZZZVVZZZVVZZZZZZVVZZZVVZZZZZZVVZZZZZZZZZVVVZZZZVVVZZZ11
11ZZZZZZZZZZVVZZZZZZZZZZZZVVZVVVZZVVVZZVZZZVVVZZZVVVVVVZZZZZZZVVVZZZZVVVVZZZ11
11ZZZZZZZVVVVVVVVVVVZZZZZZZVVVZZZVVZVZZVVZVVVZZZVVVZVVVVVZZZZZVVVZZZZVVVZZZZ11
11ZZZZZZVVZZZZZZVVVZZVVVVVZZZZZEVVZZXZZZVVVVZZZVVVZZZZZVVVZZZZZVVVZZVVVZZZZZ11
11ZZZZZZZVVVVRZZZVVZZVVZZVVVVZZZZZZVMVZZZZZZZZZZRZZZZCVZZVVZZZZZVVCCVVZZZZZZ11
11ZZZZZZZZZZZZZZZZVVVVVZZZZVVVVVVVVVVZZZZZZZZZZZZZZZVVVVVVZZZZZZZZZZZZZZZZZZ11
11ZZZZZZZZZZZZZZZZZZZZZZZZZZZZZZZZZZZZZZZZZZZZZZZZZZZZZZZZZZZZZZZZZZZZZZZZZZ11
111111111111111111111111111111111111111111111111111111111111111111111111111111