111111111111111111111111111111111111111111111111111111111111111111111111111111
11ZZZZZZZZZZZZZZZZZZZZZZZZZZZZZZZZZZZZZZZZZZZZZZZZZZZZZZZZZZZZZZZZZZZZZZZZZZ11
11ZZZRVVVZZZZZZVVVVVVVZZZZZZZZVVVVVVVVVVVVVVZZZVVVVVVVVVVVVVVVVZZZZZVVCZZZZZ11
11ZZZZZVVZZZZZVVZZZZZZZZZZZZZVVVZZZZZZZZZZVVVVVVVZZZVVVZZZZZZVVVZZZVVZZZVEZZ11
11ZZZZVVZZZZZZZVVVZZZZZZZZZZZZVVZZZZZVVVVZZZZZZZZZZZZVVVZZZZZZVVVVVVZZZVVZZZ11
11ZZZZVVVVVZZZZZVVVVVVVVZZZZZZZVVZZZVVZZVVVVVVVZZZZZZZZVVZZZZZZZZZVZZZVVZZZZ11
11ZZVVVZZZVVVZZZZVZZZZVVVZZZZZZVVZZZVZZZZZZVZZVVZZZZZZVVZZZZZZZZVVVZZZVVZZZZ11
11ZZVVZZZZZVVVVVVVZZZVVVZZZZZZZZVVVVVVZZZZVVZZZVRZZZZVVZZZZZZZZZVVZZZZZVXZZZ11
11ZZVVZZZZZZZZZZZZZZZZVVVZZZZZZZZZZZVVVZZVVZZZVVZZZZZZVVZZZZZZZVVZZZZZZZMVZZ11
11ZZVVVZZZZZZZZVVCZZZZZVVZZZZZZZZZZVVVZZCVZZVVVVZZZZZZZVVVVZZVVVVZZZZZZZVVZZ11
11ZZZVVZZZZZZZVVVZZZZZZZVVZZZZZZZZVVVZZZZZZVVZZZZZZZZVVVZZVVVVZVVZZZZZZVVVZZ11
11ZZZZVVVVZZZVVVZZZZZPZZVVVZZZZZZZZVVZZZZZZZVVZZZZZZZVVZZZZZZZZVVVVZZZVVVZZZ11
11ZZZZZVVVVVVVVZZZZZVVZZZVVRZZZZZZZVVVZZZZVVVZZZZZZZVVZZZZZZZZZZZVVVVVVZZZZZ11
11ZZZZZZZZVVVVZZZZZVVVZZVVVZZZZZZZZZVVVVVVVZZZZZZZZVVVVVZZVVCZZZZZZVVVZZZZZZ11
11ZZVVVVVVVVZZZVVZZVVZZZVVZZZZZZZZZZZVVVZZZZZZZZZZVVZZVVVVVZZZZZZZVVVZZZZZZZ11
11ZZVVZZZZZZZVVVZZVVZZZVVVZZZZZZZZZZVVZZZZZZZZZZZVVZZZZZZZZZZZZZZZZZVVVZZZZZ11
11ZZVVZZVVVVVVVVZZZCZZZZVVVZZZZZZZZVVZZZZZZZZZZZZVVVZZZZZVVVVVVVVVZZZVVVZZZZ11
11ZZVVZVVZVVZZZZZZZVVZZZZVVVZZZZZZZZVVZZZZZZZZZZZZVVVZZVVVVZZZZZVVVVVVVZZZZZ11
11ZZVVVVZZZVVVVZZZVVVZZZZZVVVVVVVVVVVVZZZZZZZZZZZZZVVZZVVZZZZKVZZZVVZZZZZZZZ11
11ZZZCZZZZZZVVVVVVCVZZZZZZZZVVVVVVVVZZZZZZZZZZZZZZZZVVVVZZZZZZVVVVVVZZZZZZZZ11
11ZZZZZZZZZZZZZZZZZZZZZZZZZZZZZZZZZZZZZZZZZZZZZZZZZZZZZZZZZZZZZZZZZZZZZZZZZZ11
111111111111111111111111111111111111111111111111111111111111111111111111111111