111111111111111111111111111111111111111111111111111111111111111111111111111111
11ZZZZZZZZZZZZZZCZZZZRZZZZZZZZZZZZZZZZZCVVZZZZZZZZZZZZZZZZZRZZZZZZZZZZZZZZEZ11
11ZZZZZZZZZZZZZZVZZZZVZZZZZZZZZZZZZZZZZZZVVVZZZZZZZZZZZZZZZVVVVZZZZZZZZZZZVZ11
11ZZZZZZZRVVVVVVVVVVVVZZZZZZZZZZZZZZZZZZZZZVVVZZZZZZZZZZZZZZZZVZZZZZZZZZZZXZ11
11ZZZZZZZZZZZZZZVZZZZVZZZZZZZZZZZZZVVVZZZZZZZVVZZZZZZZZZZZZZVVVZZZZZZZVVVVVZ11
11CZZZZZZZZZZZZZVVZZVVVZZZZZZZZZZVVVZZZZZZZZZZVVZZZZZZZZZZZVVZZZZZVVVVVZZZVV11
11CZZZZZZZZZZZZZZVVVVZZVVVZZZZZZVVZZZZZZZZZZZZZVZZZZZZZZZZZVZZZZZZVZZZZZZZZV11
11CZZZZZZZZZZZZZVVZZZZZZZVVVZZZZVZZZZZZZZZZZZZZVZZZZZZZZZZZVZZZZZZVZZZZZZZZV11
11VVVZZZZZZZZZZZZVVZZZZZZZZVZZVVVZZZZZZZZZZZZZVVVVZZZZZZZZZVVZZZVVVZZZZZZVVV11
11ZZVVZZZZZZZZZZZZVZZZZZZZZVVVVZZZZZZZZZZZZZZZVZZVZZZZZZZZZZVZZZVZZZZZZZZVVZ11
11ZZVVZZZZZZZZZVVVVZZZZZZZZZVZZZVVVZZZZZZZZZZVVZZVZZZZZZZZZVVZZZVZZZZZZZZVVZ11
11ZZVVZZZZZZZZVVZZVVVZZZZZZVVVZZZZVVVVZZZZZVVVZZZVVZZZZZZZVVZZZZVZZZZZZZZZVZ11
11CZVVZZZZZZZZVZZZZVVVVZZZZZVZZZZZZZZVVZZZVVZZZZZZVVZZZZZZVVVVVVVVVVZZZVVVVZ11
11VZZVZVVZZZZVVZZZZZZZVZZZZVVZZZZZZZZZVVZZVZZZZZZZZVZZZZZZZZZZZZVZZVVVZVVZZZ11
11VVVVZZVVZZZRZZZZZZZVVZZZZVZZZZZZZZZZZVVVVZZZZZZZZVVZZZZZZZZZZZVZZZZVVVZZZZ11
11ZZZVVVZVVVZZZZZZZZVVVZZZZVVZZZZZZZZZZZVVZZZZZZZZZZVZZZZZZZZZZZVZZZZZZVRZZZ11
11ZZVVVVVZVVZZVVVVVZZVVZZZZZZCZZZZZZZZZZVZZZZZZZZZZZVVVZZZZZZVVVVZZZZZZZZZZZ11
11ZVVVZZVVZVVZZZZZVZZZVZZZZZZZZZVVVZZZZZVZZZZZZZZZZZZVVVVVVVVVZZZZZZZZZZZZZZ11
11ZVVZZZZVVZVVVVVVVVVVVVZZZZZVVVVZVVZZZVVZZZZZZZZZZZZZZZZZZZZVZZZZZZZZZZZZZZ11
11ZVVZZZZVZZZVZZZZZZZZZVZZZZVVZZVZZVVVVVZZZZZZZZZZZZZZZZZZZZZVVZZZZZZZZZZZZZ11
11PCZZZZZVVVVZZZZZZZZZZVVVVVVZZZZZZZZZZZZZZZZZZZZZZZZZZZZZZZZZVVVVCZZZZZZZZZ11
111111111111111111111111111111111111111111111111111111111111111111111111111111