111111111111111111111111111111111111111111111111111111111111111111111111111111
11VVVVVVVVVVVVVVVVVVVVVVVVVVMVVVVVVVVXVVVVVWWWWWWWWWWVVVVVVVVVVVVVVVVVVVVVVP11
11VWWWWWWWWWWWWWWWWWWWWWWWWWWWWWWWWWWWWWWWVWWWWWWWWWWVWWWWWWWWWWWWWWWWWWWWWW11
11VWCRVVVVVVVVVVVVVVVVVVVVVVVVVVWVVVVVVVVWVWVVVVVVVVWVVVVVVVVVVVVVVVVVVVVVVV11
11VWWWWWWWWVWWWWWWWWWWWWWWWWWWWVWVVVWWWVVWVWVVVVVVVVWWWWWWWWWWWWWWWWWWWWWWVV11
11VWVVVVVVVVWVVVVVVVVVVVVVVVVVVVWVVWVWVVVWVWVVCRCVVVWVVVVVVVVVVVVVVVVVVVVVVV11
11VWVWWWWWRWVVWWWWWWWWWWWWWWWWWVWVVVVWVVVWVWVVRRRVVVWVWWWWWWWWWWWWWWWWWWWWWW11
11VWVVVVVVWVVWVVVVVVVVVVVVVVVVVVWVVVVWVVVWVWVVCCCVVVWVVVVVVVVVVVVVVVVVVVVVVV11
11VWWWWVCWVVWVVWWWWWWWWWWWWWWVWWWVVVVWVVVWVWVVVVVVVVWWWWWWWWWWWWWWWWWWWWWWWC11
11VWVVVVWVVWVVWCVVWVVVVVVVVVVVVCWVVVVVWVVWVWVVVVWWWWWVVVVVVVVVVVVVVVVVVVVVWV11
11VWVVVWVVWVVWVVWVWWVWWWWWWWWWWWWVVVVVVWKWVWVVVVWWVVWVWWWWWWWWWWWWWWWWWWVWWV11
11VWVVWVVWVVWVVWVVVWVWVVVVVVVVVVWVVVWVVVWWEWVVVVWWVVWVVWVVVVVWVVRVVVVCCWVVWV11
11VWVVWVWWVWVVWVVWVWVVVWWWWWWWWVWVVWVWWWVWWWVVVVWWVVWWVWVVWVVWVVWWWWWWWWWVWV11
11VWVVWVCVVWVVWVVWVWWWWWVVVVVVVVWVVWVVVVWVVVVVVVWWVVWVVWVVWVVVVVWCVVVVVVVVVV11
11VWVVWWWWWVVVWVVWVVVVVVVWWVWWWVWVVVVVWVVWVVVVVVWWVVWVWWVVWWWWWWWWWWWWWWWWWW11
11VWVVWCCWVVWWVVVWWWWWWWVVVVVRWVWWCWRWWWVVVVVVVVWWVVWVVWVVVVVVVVVVVVVVVVVVWC11
11VWVVVWVVWVVWWWVVVWVVVWWWWWWWWVWWWWWWWWWWVWVVVVVVVVWVVWWWWWWWWWWWWWWWRWVVWV11
11VWWWVVWVVWVVVWRWVVVWVWVVVVVVVVWWWWWWWWWWVWWWWWWWWWWVVVVVVVVVVVVVVVVVVWVVVV11
11VWVVVVVWRRWVVWWWWWWCCWVWWWWWWWWWWWWVVVVVVWWWVVVVVVWWWWWWWWWWWWWWWWWWWWWWWV11
11VWVWWWWWWVVWVVVWVVVWWVVVVVVVVVVVVVVVVVVVVVVVVVVVVVVVVVVVVVVVVVVVVVVVVVVVVV11
11VVVVVVVVVVVCWWVVVWVVVVVWWWWWWWWVVVVVVVVVWWWWVVVVVVVVVVVVVVVVVVVVVVVVVVVVVV11
111111111111111111111111111111111111111111111111111111111111111111111111111111