111111111111111111111111111111111111111111111111111111111111111111111111111111
11VVVVVVVVVVVVVVVVVVVVVVVVVVVVVVRVVVVXVVVVVWVVVVVVVVWVVVVVVVVVVVVVVVVVVVVVVP11
11VWWWWWWWWWWWWWWWWWWWWWWWWWWWWWWWWWWWWWWWVWVVVVVVVVWVWWWWWWWWWWWWWWWWWWWWWW11
11VWCRVVVVVVVVVVVVVVVVVVVVVVVVVVWVVVVVVVVWVWVVVVVVVVWVRVVVVVVVVVVVVVVVVVVVVV11
11VWWWWWWWWVWWWWWWWWWWWWWWWWWWWVWVVVVVVVVWVWVVVVVVVVWWWWWWWWWWWWWWWWWWWWWWVV11
11VWVVVVVVVVWVVVVVVVVVVVVVVVVVVVWVVVVVVVVWVWVVVVVVVVWVVVVVVVVVVVVVVVVVVVVVVV11
11VWVWWWWWRWVVWWWWWWWWWWWWWWWWWRWVVVVVVVVWVWVVVVVVVVWVWWWWWWWWWWWWWWWWWWWWWW11
11VWVVVVVVWVVWVVVVVVVVVVVVVVVVRRWVVVVVVVVWVWVVVVVVVVWVVVVVVVVVVVVVVVVVVVVVVV11
11VWWWWVCWVVWVVWWWWWWWWWWWWWWVWWWVVVVVVVVWVWVVVVVVVVWWWWWWWWWWWWWWWWWWWWWWWR11
11VWVVVVWVVWVVWCVVWVVVVVVVVVVVVCWVVVVVVVVWVWVVVVVVVVWVVVVVRVVVVVVVVVVVVVVVWV11
11VWVVVWVVWVVWVVWVWWVWWWWWWWWWWWWVVVVVVVVWVWVVVVVVVVWVWWWWWWWWWWWWWWWWWWVWWV11
11VWVVWVVWVVWVVWVVVWVWVVVVVVVVVVWVVVVVVVVWEWVVVVVVVVWVVWVVVVVWVVRVVVVCCWVVWV11
11VWVVWVWWVWVVWVVWVWVVVWWWWWWWWVWVVVVVVVVWWWVVVVVVVVWWVWVVWVVWVVWWWWWWWWWVWR11
11VWVVWVCVVWVVWVVWVWWWWWVVVVVVVVWVVVVVVVVVVVVVVVVVVVWVVWVVWVVVVVWCRVVVVVVVVV11
11VWVVWWWWWVVVWVVWVVVVVVVWWVWWWVWVVVVVVVVVVVVVVVVVVVWVWWVVWWWWWWWWWWWWWWWWWW11
11VWVVWCCWVVWWVVVWWWWWWWVVVVVRWVWVVVVVVVVVVVVVVVVVVVWVVWVVVVVVVVVVVVVVVVVVWC11
11VWVVVWVVWVVWWWVVVWVVVWWWWWWWWVWVVVVVVVVVVVVVVVVVVVWVVWWWWWWWWWWWWWWWRWVVWV11
11VWWWVVWVVWVVVWRWVVVWVWVVVVVVVVWWWWWWWWWWWWWWWWWWWWWVVVVVVVVVVVVVVVVVVWVVVV11
11VWVVVVVWRRWVVWWWWWWCCWVWWWWWWWWWWWWBBBBBWWWWBBBBBBWWWWWWWWWWWWWWWWWWWWWWWV11
11VWVWWWWWWVVWVVVWVVVWWVVVVVVVVVVVVVVBBBBBBBBBBBBBBBVVVVVVVVVVVVVVVVVVVVVVVV11
11VVVVVVVVVVVCWWVVVWVVVVVWWWWWWWWVVVVBBBBBWWWWBBBBBBVVVVVVVVVVVVVVVVVVVVVVVV11
111111111111111111111111111111111111111111111111111111111111111111111111111111