111111111111111111111111111111111111111111111111111111111111111111111111111111
11VVVVVWVCLVVLVVLVVVVVVVVVVVVVVVVVVVWEWVVVVVVVVVVVVVVVVVVVVVVLVVLVVLCVWVVVVV11
11VVVVVWVVVVVVVVVVVVVVVVVWWWWWWWWWWWWVWWWWWWWWWWWWVVVVVVVVVVVVVVVVVVVVWVVVVV11
11VVVVVWVVLVVLVVLVVVVVVVVWVVVWVVVVVVWVWVVVVVVWVVVWVVVVVVVVVVVLVVLVVLVVWVVVVV11
11VVVVVWVVVVVVVVVVVVVVVVVWVWVWVVLVVLVXVLVVLVVWVWVWVVVVVVVVVVVVVVVVVVVVWVVVVV11
11VVVVVWVVLVVLVVLVVVVVVVVWVWVWVVVVVVVVVVVVVVVWVWVWVVVVVVVVVVVLVVLVVLVVWVVVVV11
11VVVVVWVVVVVVVVVVVVVVVVVWVWVWVVLVVLVVVLVVLVVWVWVWVVVVVVVVVVVVVVVVVVVVWVVVVV11
11VVVVVWVVLVVLVVLVVVVVVVVWVWVWVVVVVVWVWVVVVVVWVWVWVVVVVVVVVVVLVVLVVLVVWVVVVV11
11VVVVVWVVVVVVVVVVVVVVVVVWVWVWWWWWWWWCWWWWWWWWVWVWVVVVVVVVVVVVVVVVVVVVWVVVVV11
11VVVVVWVVLVVLVVLVVVVVVVVWVWVVVVVVVVVVVVVVVVVVVWVWVVVVVVVVVVVLVVLVVLVVWVVVVV11
11VVVVVWVVVVVVVVVVVVVVVVVWVWWWWWWWWWWWWWWWWWWWWWVWVVVVVVVVVVVVVVVVVVVVWVVVVV11
11VVVVVWVVLVVLVVLVVVVVVVVWVVVVVVVVVVTVTVVVVVVVVVVWVVVVVVVVVVVLVVLVVLVVWVVVVV11
11VVVVVWVVVVVVVVVVVVVVVVVWWWWWWWWWWVVVVVWWWWWWWWWWVVVVVVVVVVVVVVVVVVVVWVVVVV11
11VVVVVWVVLVVLVVLVVVVVVVVVVVVVVVVVVVTVTVVVVVVVVVVVVVVVVVVVVVVLVVLVVLVVWVVVVV11
11VVVVVWVVVVVVVVVVVVVVVVVVVVVVVVVVVVVVVVVVVVVVVVVVVVVVVVVVVVVVVVVVVVVVWVVVVV11
11VVVVVWVVLVVLVVLVVVVVVVVVVVVVVVVVVVTVTVVVVVVVVVVVVVVVVVVVVVVLVVLVVLVVWVVVVV11
11VVVVVWVVVVVVVVVVVVVVVVVVVVVVVVVVVVVVVVVVVVVVVVVVVVVVVVVVVVVVVVVVVVVVWVVVVV11
11VVVVVWWWWWWWWWWWWWWWWWWWWWWWWWWWWWWCWWWWWWWWWWWWWWWWWWWWWWWWWWWWWWWWWVVVVV11
11VVVVVVVVVVVVVVVVVVVVVVVVVVVVVVVVVVWVWVVVVVVVVVVVVVVVVVVVVVVVVVVVVVVVVVVVVV11
11VVVVVVVVVVVVVVVVVVVVVVVVVVVVVVVVVVWPWVVVVVVVVVVVVVVVVVVVVVVVVVVVVVVVVVVVVV11
11VVVVVVVVVVVVVVVVVVVVVVVVVVVVVVVVVVWWWVVVVVVVVVVVVVVVVVVVVVVVVVVVVVVVVVVVVV11
111111111111111111111111111111111111111111111111111111111111111111111111111111