111111111111111111111111111111111111111111111111111111111111111111111111111111
11WWWWWWWWWWWWWWWWWWWWWWWWWWWWWWWWWWWWWWWWWWWWWWWWWWWWWWWWWWWWWWWWWWWWTTTTWW11
11WWP WWWWWWW                  WWWWWWWW TTTTWWWWWTWWWWWWTWWWWWWWWWWWTTTC TTW11
11WW           WWWWWWTTTTTTTTW  WWWWWWW TTT TWWWWWWWWWWTTTWWWTTWWWWWTTTT TTW11
11WWTWTTWWWWWWWWWWWWWWTTTTTTWWW   WWWWTTT  TTWWWWWWWW          TWWWTTTTW  TW11
11TTWTWTTTWWWWWWTTTWWWWWTTTWWWWW   WWWWTTTTTWWWWWW    WWWWWWW  WWWWWTT   TTW11
11WTTTWEWWWWWWTTTWWWWWWWWWWWTTTWWW   WWWWWWWWWWW   WTTTTWW     WWWWTTW  WWTW11
11TTWWW  WWWWWWWWWWWWW     WWWTTTWWW              WWTTTTW      WWWWWTWW  WWW11
11TTTTW  WWWWWWWWWW    WWW  WWWTTTTWWWTTTWWTTTWWWWTTTWWWWWW   WWWWWWTT     W11
11TWTWW  TWWWTWWWW    WWWWT    WWWWTTTTTTTTTTWWWWWTT           WWWWWWTTT  WW11
11WTTWW  TTWWWWWWWW  WWWWWWW    WWWWWWTWWWTTWWWWW  T  TT  WWWWWWWW    TT  WW11
11TWTWW  TTWWWWWWW  WWWTWWWWWW                       TT   TTWWWWR  TW  TT WW11
11WTTTW   TWWWW     WWWWWWWWWWWWWWWWWW      WWWWWWWWWT   WWTTTWWWWTTWW TT WW11
11WTTTTT   X        WWWWTTTTTTTTWWWWWWWW WWWWWWWTTTWWT  WWW     WWWWWW    WW11
11TTWTTTWWWWWWW     WWWWWWTTWWWWWWWWWWWW WWWWWTTTTTWWT  WW  TT   WWWWWW  WWW11
11WWWTTTWWWWWWWWW WWWWTWWWWWWWWWWTTWWWWW  WWWTTTTWTWWT  WWT  TT  TTT      WW11
11WTTWTTTTTWWWWWW   WWWWTTTWWWWWWW     WW  WWWWTWTTWWWW     TT   TT   TWWWWW11
11WWWWWTTTWWWWWWWWW    WWWWWW      WWW    WWWWWWTWTTWWWWWWWWTT  TT    TWWWWW11
11WWWWWTTTTWWWWWWWWWWW        WWWWWWTTWW WWWWWWWTTWTTTWWWWWT   TTT  TTWWWWWW11
11WWWWWWWWTTTWTTTTWWWWWWTTTWWWWWWTTTTTWW   CWWWTTTWWWWTTWWWWT      TTWWWWWWW11
11WWWTWWWWWTTTTTWTTWWWWWWTWWWWTTTTTTTWWWWWWWWWWWWWWWWWWWWWWWWWWWWWWWWWWWWWWW11
111111111111111111111111111111111111111111111111111111111111111111111111111111
