111111111111111111111111111111111111111111111111111111111111111111111111111111
11WWWWWWWWWWWWWWWWWWWWWWWWWWWWWWWWWWWWWWWWWWWWWWWWWWWWWWWWWWWWWWWWWWWWWWWWWW11
11WWP WWWWWWW                   WWWWWWWWWWWWWWWWWWWWWWWWTWWWWWWWWWWWWWWWCWWW11
11WW           WWWWWWTTTTTTTTWW WWWWWWWWWWWWWWWWWWWWWWWTTTWWWTTWWWWWWWWW WWW11
11WWWWWWWWWWWWWWWWWWWWTTTTTTWWW   WWWWWWWWWWWWWWWWWWW          TWWWWWWWW WWW11
11WWWWWWWWWWWWWWWWWWWWWWTTTWWWWW   WWWWWWWWWWWWWWW    WWWWWWW  WWWWWWWWW WWW11
11WWWWWE WWWWWWWWWWWWWWWWWWWWWWWWW   WWWWWWWWWWW   WWWWWWW     WWWWWWWWW WWW11
11WWWWW  WWWWWWWWWWWWWWWWWWWWWWWWWWW              WWWWWWW      WWWWWWWWW WWW11
11WWWWW  WWWWWWWWWW          WWWWWWWWWWWWWWWWWWWWWWWWWWWWWWW   WWWWWWWWW WWW11
11WWWWW  WWWWWWWWW    WWWWT    WWWWWWWWWWWWWWWWWWW             WWWWWWWWW WWW11
11WWWWW  WWWWWWWWWW  WWWWWWW    WWWWWWWWWWWWWWWWW  T   T  WWWWWWWW     W WWW11
11WWWWW  WWWWWWWWWW WWWTWWWWWW                       T      WWWWR   WW W WWW11
11WWWWW  WWWWWW     WWWWWWWWWWWWWWWWWW      WWWWWWWWWT   WWWWWWWWWWWWW W WWW11
11WWWWW  X          WWWWTTTTTTTTWWWWWWWW WWWWWWWWWWWWT  WWW     WWWWWW   WWW11
11WWWWWWWWWWWWW     WWWWWWTTWWWWWWWWWWWW WWWWWWWWWWWWT  WWW  W  WWWWWWW WWWW11
11WWWWWWWWWWWWWWW WWWWTWWWWWWWWWWTTWWWWW WWWWWWWWWWWWT  WWW  W  WWWW      WW11
11WWWWWWWWWWWWWWW   WWWWTTTWWWWWWW       WWWWWWWWWWWWWW      W  WW    WWWWWW11
11WWWWWWWWWWWWWWWWW    WWWWWW      WWWWW WWWWWWWWWWWWWWWWWWWWW  WW    WWWWWW11
11WWWWWWWWWWWWWWWWWWWW        WWWWWWWWWW WWWWWWWWWWWWWWWWWWWWW  WW  WWWWWWWW11
11WWWWWWWWWWWWWWWWWWWWWWWWWWWWWWWWWWWWWW   CWWWWWWWWWWWWWWWWWW      WWWWWWWW11
11WWWWWWWWWWWWWWWWWWWWWWWWWWWWWWWWWWWWWWWWWWWWWWWWWWWWWWWWWWWWWWWWWWWWWWWWWW11
111111111111111111111111111111111111111111111111111111111111111111111111111111