111111111111111111111111111111111111111111111111111111111111111111111111111111
11WWWWWWWWWWWWWWWWWWWWWWWWWWWWWWWWWWWWWWWWWWWWWWWWWWWWWWWWWWWWWWWWWWWWTTTTWW11
11WWP WWWWWWW                   WWWWWWW TTTTWWWWWTWWWWWWTWWWWWWWWWWWTTT CTTW11
11WW           WWWWWWTTTTTTTTWW WWWWWWW TTT TWWWWWWWWWWTTTWWWTTWWWWWTTTT TTW11
11WWTWTTWWWWWWWWWWWWWWTTTTTTWWW   WWWWTTT  TTWWWWWWWW          TWWWTTTTW  TW11
11TTWTWTTTWWWWWWTTTWWWWWTTTWWWWW   WWWWTTTTTWWWWWW    WWWWWWW  WWWWWTT   TTW11
11WTTTWE WWWWWTTTWWWWWWWWWWWTTTWWW   WWWWWWWWWWW   WTTTTWW     WWWWTTW  WWTW11
11TTWWW  WWWWWWWWWWWWWWWWWWWWWTTTWWW              WWTTTTW      WWWWWTWW  WWW11
11TTTTW  WWWWWWWWWW          WWWTTTTWWWTTTWWTTTWWWWWTTWWWWWW   WWWWWTT     W11
11TWTWW  WWWWTWWWW    WWWWT    WWWWTTTTTTTTTTWWWWW             WWWWWWTTT  WW11
11WTTWW  WWWWWWWWWW  WWWWWWW    WWWWWWTWWWTTWWWWW  T   T  WWWWWWWW    TT  WW11
11TWTWW  WWWWWWWWWW WWWTWWWWWW                       T    TTWWWWR  TW  TT WW11
11WTTTW  WWWWWW     WWWWWWWWWWWWWWWWWW      WWWWWWWWWT   WWTTTWWWWTTWW TT WW11
11WTTTW  X          WWWWTTTTTTTTWWWWWWWW WWWWWWWTTTWWT  WW      WWWWWW    WW11
11TTWWWWWWWWWWW     WWWWWWTTWWWWWWWWWWWW WWWWWTTTTTWWT  WW  TT   WWWWWW WWWW11
11WWWTTTWWWWWWWWW WWWWTWWWWWWWWWWTTWWWWW WWWWTTTTWTWWT  WWT  TT  TTT      WW11
11WTTWTTTTTWWWWWW   WWWWTTTWWWWWWW       WWWWWWTWTTWWWW     TT   TT   TWWWWW11
11WWWWWTTTWWWWWWWWW    WWWWWW      WWWWW WWWWWWWTWTTWWWWWWWWTT  TT    TWWWWW11
11WWWWWTTTTWWWWWWWWWWW        WWWWWWTTWW WWWWWWWTTWTTTWWWWWT   TTT  TTWWWWWW11
11WWWWWWWWTTTWTTTTWWWWWWTTTWWWWWWTTTTTWW   CWWWTTTWWWWTTWWWWT      TTWWWWWWW11
11WWWTWWWWWTTTTTWTTWWWWWWTWWWWTTTTTTTWWWWWWWWWWWWWWWWWWWWWWWWWWWWWWWWWWWWWWW11
111111111111111111111111111111111111111111111111111111111111111111111111111111