111111111111111111111111111111111111111111111111111111111111111111111111111111
11WWWWWWWWWWWWWWWWWWWWWWWWWWWWWWWWWWWWWWWWWWWWWWWWWWWWWWWWWWWWWWWWWWWWWWWWWW11
11WWPGWWWWWWWGGGGGGGGGGGGGGGGGGGWWWWWWWGTTTTWWWWTTWWWWWWTWWWWWWWWWWWWWTWCWWW11
11WWGGGGGGGGGGGWWWWWWTTTTTTTTWWGWWWWWWWGTTTGWWWWWWWWWWWTTTWWWTTWWWWWWWWWGWWW11
11WWWWWWWWWWWWWWWWWWWWTTTTTTWWWGGGWWWWWGGGGGWWWWWWWWWGGGGGGGGGGTWWWTWWWWGWWW11
11WWWWWWWTWWWWWWWWWWWWWWTTTWWWWWGGGWWWWWWWWWWWWWWWGGGGWWWWWWWGGWWWWWWWWWGWWW11
11WWTWWEGWWWWWTWWWWWWWWWWWWWWWWWWWGGGWWWWWWWWWWWGGGWWWWWWWGGGGGWWWWTWWWWGWWW11
11WWWWWGGWWWWWWWWWWWWWWWWWWWWWWWWWWWGGGGGGGGGGGGGGWWWWWWWGGGGGGWWWWWTWWWGWWW11
11WWWWWGGWWWWWWWWWWGGGGGGGGGGWWWWWWWWWWWWWWWWWWWWWWWWWWWWWWWGGGWWWWWWTWWGWWW11
11WWTWWGGWWWWTWWWWGGGGWWWWTGGGGWWWWTWWWWWWTWWWWWWWGGGGGGGGGGGGGWWWWWWTWWGWWW11
11WWWWWGGWWWWWWWWWWGGWWWWWWWGGGGWWWWWWTWWWWWWWWWWGGTGGGTGGWWWWWWWWGGGGGWGWWW11
11WWTWWGGWWWWWWWWWWGWWWTWWWWWWGGGGGGGGGGGGGGGGGGGGGGGTGGGGGGWWWWRGGGWWGWGWWW11
11WWWWWGGWWWWWWGGGGGWWWWWWWWWWWWWWWWWWGGGGGGWWWWWWWWWTGGGWWWWTWWWWTTWWGWGWWW11
11WWWTWGGXGGGGGGGGGGWWWWTTTTTTTTWWWWWWWWGWWWWWWWWWTWWTGGWWWGGGGGWWWWWWGGGWWW11
11WWWWWWWWWWWWWGGGGGWWWWWWTTWWWWWWWWWWWWGWWWWWWWWTWWWTGGWWWGGWGGWWWWWWWGWWWW11
11WWWWWWWWWWWWWWWGWWWWTWWWWWWWWWWTTWWWWWGWWWWWWWTWWWWTGGWWWGGWGGWWWWGGGGGGWW11
11WTWWTTTTTWWWWWWGGGWWWWTTTWWWWWWWGGGGGGGWWWWWWTWWWWWWWGGGGGGWGGWWGGGGWWWWWW11
11WWWWWTTTWWWWWWWWWGGGGWWWWWWGGGGGGWWWWWGWWWWWWWWWWTWWWWWWWWWWGGWWGGGGWWWWWW11
11WWWWWTTTTWWWWWWWWWWWGGGGGGGGWWWWWWWWWWGWWWWWWWWWWWWWWWWWWWWWGGWWGGWWWWWWWW11
11WWWWWWWWWWWWWWWWWWWWWWTTTWWWWWWWWWWWWWGGGCWWWWWWWWWWTTWWWWWWGGGGGGWWWWWWWW11
11WWWTWWWWWWWWWWWWWWWWWWWTWWWWWWWWWWWWWWWWWWWWWWWWWWWWWWWWWWWWWWWWWWWWWWWWWW11
111111111111111111111111111111111111111111111111111111111111111111111111111111