111111111111111111111111111111111111111111111111111111111111111111111111111111
11WWWWWWWWWWWWWWWWWWWWWWWWWWWWWWWWWWWWWWWWWWWWWWWWWWWWWWWWWWWWWWWWWWWWWWWWWW11
11WWP WWWWWWW                   WWWWWWW TTTTWWWWWTWWWWWWTWWWWWWWWWWWWWTWCWWW11
11WW           WWWWWWTTTTTTTTWW WWWWWWW TTT WWWWWWWWWWWTTTWWWTTWWWWWWWWW WWW11
11WWWWWWWWWWWWWWWWWWWWTTTTTTWWW   WWWWW     WWWWWWWWW          TWWWTWWWW WWW11
11WWWWWWWTWWWWWWWWWWWWWWTTTWWWWW   WWWWWWWWWWWWWWW    WWWWWWW  WWWWWWWWW WWW11
11WWTWWE WWWWWTWWWWWWWWWWWWWWWWWWW   WWWWWWWWWWW   WWWWWWW     WWWWTWWWW WWW11
11WWWWW  WWWWWWWWWWWWWWWWWWWWWWWWWWW              WWWWWWW      WWWWWTWWW WWW11
11WWWWW  WWWWWWWWWW          WWWWWWWWWWWWWWWWWWWWWWWWWWWWWWW   WWWWWWTWW WWW11
11WWTWW  WWWWTWWWW    WWWWT    WWWWTWWWWWWTWWWWWWW             WWWWWWTWW WWW11
11WWWWW  WWWWWWWWWW  WWWWWWW    WWWWWWTWWWWWWWWWW  T   T  WWWWWWWW     W WWW11
11WWTWW  WWWWWWWWWW WWWTWWWWWW                       T      WWWWR   WW W WWW11
11WWWWW  WWWWWW     WWWWWWWWWWWWWWWWWW      WWWWWWWWWT   WWWWTWWWWTTWW W WWW11
11WWWTW  X          WWWWTTTTTTTTWWWWWWWW WWWWWWWWWTWWT  WWW     WWWWWW   WWW11
11WWWWWWWWWWWWW     WWWWWWTTWWWWWWWWWWWW WWWWWWWWTWWWT  WWW  W  WWWWWWW WWWW11
11WWWWWWWWWWWWWWW WWWWTWWWWWWWWWWTTWWWWW WWWWWWWTWWWWT  WWW  W  WWWW      WW11
11WTWWTTTTTWWWWWW   WWWWTTTWWWWWWW       WWWWWWTWWWWWWW      W  WW    WWWWWW11
11WWWWWTTTWWWWWWWWW    WWWWWW      WWWWW WWWWWWWWWWTWWWWWWWWWW  WW    WWWWWW11
11WWWWWTTTTWWWWWWWWWWW        WWWWWWWWWW WWWWWWWWWWWWWWWWWWWWW  WW  WWWWWWWW11
11WWWWWWWWWWWWWWWWWWWWWWTTTWWWWWWWWWWWWW   CWWWWWWWWWWTTWWWWWW      WWWWWWWW11
11WWWTWWWWWWWWWWWWWWWWWWWTWWWWWWWWWWWWWWWWWWWWWWWWWWWWWWWWWWWWWWWWWWWWWWWWWW11
111111111111111111111111111111111111111111111111111111111111111111111111111111