

  WWWWWWWWWWWWWWWWWWWWWWWWWWWWWWWWWWWWWWWWWWWWWWWWWWWWWWWWWWWWWWWWWWWWWWWWWW
  WWP WWWWWWW                   WWWWWWWWWWWWWWWWWWWWWWWWTWWWWWWWWWWWWWWWCWWW
  WW           WWWWWWTTTTTTTTWW WWWWWWWWWWWWWWWWWWWWWWWTTTWWWTTWWWWWWWWW WWW
  WWWWWWWWWWWWWWWWWWWWTTTTTTWWW   WWWWWWWWWWWWWWWWWWW          TWWWWWWWW WWW
  WWWWWWWWWWWWWWWWWWWWWWTTTWWWWW   WWWWWWWWWWWWWWW    WWWWWWW  WWWWWWWWW WWW
  WWWWWE WWWWWWWWWWWWWWWWWWWWWWWWW   WWWWWWWWWWW   WWWWWWW     WWWWWWWWW WWW
  WWWWW  WWWWWWWWWWWWWWWWWWWWWWWWWWW              WWWWWWW      WWWWWWWWW WWW
  WWWWW  WWWWWWWWWW          WWWWWWWWWWWWWWWWWWWWWWWWWWWWWWW   WWWWWWWWW WWW
  WWWWW  WWWWWWWWW    WWWWT    WWWWWWWWWWWWWWWWWWW             WWWWWWWWW WWW
  WWWWW  WWWWWWWWWW  WWWWWWW    WWWWWWWWWWWWWWWWW  T   T  WWWWWWWW     W WWW
  WWWWW  WWWWWWWWWW WWWTWWWWWW                       T      WWWWR   WW W WWW
  WWWWW  WWWWWW     WWWWWWWWWWWWWWWWWW      WWWWWWWWWT   WWWWWWWWWWWWW W WWW
  WWWWW  X          WWWWTTTTTTTTWWWWWWWW WWWWWWWWWWWWT  WWW     WWWWWW   WWW
  WWWWWWWWWWWWW     WWWWWWTTWWWWWWWWWWWW WWWWWWWWWWWWT  WWW  W  WWWWWWW WWWW
  WWWWWWWWWWWWWWW WWWWTWWWWWWWWWWTTWWWWW WWWWWWWWWWWWT  WWW  W  WWWW      WW
  WWWWWWWWWWWWWWW   WWWWTTTWWWWWWW       WWWWWWWWWWWWWW      W  WW    WWWWWW
  WWWWWWWWWWWWWWWWW    WWWWWW      WWWWW WWWWWWWWWWWWWWWWWWWWW  WW    WWWWWW
  WWWWWWWWWWWWWWWWWWWW        WWWWWWWWWW WWWWWWWWWWWWWWWWWWWWW  WW  WWWWWWWW
  WWWWWWWWWWWWWWWWWWWWWWWWWWWWWWWWWWWWWW   CWWWWWWWWWWWWWWWWWW      WWWWWWWW
  WWWWWWWWWWWWWWWWWWWWWWWWWWWWWWWWWWWWWWWWWWWWWWWWWWWWWWWWWWWWWWWWWWWWWWWWWW