

  TTTTTTTTTTTTTTTTTTTTTTTTTTTTTTTTTTTTTTTTTTTTTTTTTTTTTTTTTTTTTTTTTTTTTTTTTT
  TTTTTTTT             TTTTTTTTT    TTTT TTTTTTTT      TTTTTR    TTTTT    PT
  TTTTTTTTT  TTTTTTTT  TTTTTTTT  TT  TTT          TTTT  TTTTTTTT TTTTT  H  T
  TTTTTTTTT  TTTTTTTT  TTTTTTT  TTTT  TT TTTTTTTT TTTT                 TTTTT
  TTTTTTTTT  TTTTTTTTT         TTTTTT    TTTTTTTT       TTT TTTTTTTTTTTTTTTT
  TTTTTTTTT  TTTTTTTTTTTTTTTTT        TTTTTTTTTTTTTTTTTTTTT TTTTTTTTTTTTTTTT
  TTTTTTTTT  TTTTTTTTTTTTTTTTTTTTT TTTTTTTTTTTTTTTTTTTTTTTT         CTTTTTTT
  TTTTI          ITTTTTTTTTTTTTTTT TTTTTTTTTTTTTTTTTTTTTTTTTTT TTTTTTTTTTTTT
  TTTTTTTTT  TTTTTTTT     TTTTTTTT TTTTTTTTTTTTTTTTTTTTTTTTTTT TTTTTTTTTTTTT
  TTT        TTTTTTTT     TTTTTTTTRTTTTTTTTTTTTTTTTTTTTTTTTTTT TTTTTTTTTTTTT
  TTT TTTTTRTTTTTTTTT     TTTTTTTTTTTTTTTTTTTTTTTTTTTTTTTTTTTT TTTTTTTTTTTTT
  TTT TTTTTTTTTTTTTTTTTTTTTTTTTTTTTTTTTTTTTTTTTTTTTTTTTTTTTTTT TTTTTTT  ETTT
  TTT TTTTTTTTTTTTTTTTT           TTTTTTTTTTTTTTTTTTTTTTTTTTTT TTTTTTT   TTT
  TTT TTTTTTTTTTTTTTTTT TTTTTTTTT TTTTTTTTTTTTTTTTTTTTTTTTTTTT TTTTTTT   TTT
  TTT        TTTTTTTTTT TTTTTTTTT TTTTTTTTTTTT  RTTTTTTTTTTTTT         TTTTT
  TTT TTTTT  TTTTTTTTTT TTTT      TTTTTTTTTT   TTTTTTTTTTTTTTTTTTTTTTTTTTTTT
  TTT TTTTTT  TTTTTTTTT TTTT TTTTTTTTTTTTTT  TTTTTTTTTTTTTTTTTTTTTTTTTTTTTTT
  TTTXTTTTTTT  TTT      TTTT TTTTTTTTTTTT   TTTTTTTTTTTTTTTTTTTTTTTTTTTTTTTT
  TTT TTTTTTTT     TTTTTTTTT              TTTTTTTTTTTTTTTTTTTTTTTTTTTTTTTTTT
  TTTCTTTTTTTTTTTTTTTTTTTTTTTTTTTTTTTTTTTTTTTTTTTTTTTTTTTTTTTTTTTTTTTTTTTTTT