

  TTTTTTTTTTTTTTTTTTTTTTTTTTTTTTTTTTTTTTTTTTTTTTTTTTTTTTTTTTTTTTTTTTTTTTTTTT
  TTTTTTTTGGGGGGGGGGGGGTTTTTTTTTGGGGTTTTGTTTTTTTTGGGGGGTTTTTRGGGGTTTTTGGGGPT
  TTTTTTTTTGGTTTTTTTTGGTTTTTTTTGGTTGGTTTGGGGGGGGGGTTTTGGTTTTTTTTGTTTTTGGHGGT
  TTTTTTTTTGGTTTTTTTTGGTTTTTTTGGTTTTGGTTGTTTTTTTTGTTTTGGGGGGGGGGGGGGGGGTTTTT
  TTTTTTTTTGGTTTTTTTTTGGGGGGGGGTTTTTTGGGGTTTTTTTTGGGGGGGTTTGTTTTTTTTTTTTTTTT
  TTTTTTTTTGGTTTTTTTTTTTTTTTTTGGGGGGGGTTTTTTTTTTTTTTTTTTTTTGTTTTTTTTTTTTTTTT
  TTTTTTTTTGGTTTTTTTTTTTTTTTTTTTTTGTTTTTTTTTTTTTTTTTTTTTTTTGGGGGGGGGCTTTTTTT
  TTTTIGGGGGGGGGGITTTTTTTTTTTTTTTTGTTTTTTTTTTTTTTTTTTTTTTTTTTTGTTTTTTTTTTTTT
  TTTTTTTTTGGTTTTTTTTGGGGGTTTTTTTTGTTTTTTTTTTTTTTTTTTTTTTTTTTTGTTTTTTTTTTTTT
  TTTGGGGGGGGTTTTTTTTGGGGGTTTTTTTTRTTTTTTTTTTTTTTTTTTTTTTTTTTTGTTTTTTTTTTTTT
  TTTGTTTTTRTTTTTTTTTGGGGGTTTTTTTTTTTTTTTTTTTTTTTTTTTTTTTTTTTTGTTTTTTTTTTTTT
  TTTGTTTTTTTTTTTTTTTTTTTTTTTTTTTTTTTTTTTTTTTTTTTTTTTTTTTTTTTTGTTTTTTTGGETTT
  TTTGTTTTTTTTTTTTTTTTTGGGGGGGGGGGTTTTTTTTTTTTTTTTTTTTTTTTTTTTGTTTTTTTGGGTTT
  TTTGTTTTTTTTTTTTTTTTTGTTTTTTTTTGTTTTTTTTTTTTTTTTTTTTTTTTTTTTGTTTTTTTGGGTTT
  TTTGGGGGGGGTTTTTTTTTTGTTTTTTTTTGTTTTTTTTTTTTGGRTTTTTTTTTTTTTGGGGGGGGGTTTTT
  TTTGTTTTTGGTTTTTTTTTTGTTTTGGGGGGTTTTTTTTTTGGGTTTTTTTTTTTTTTTTTTTTTTTTTTTTT
  TTTGTTTTTTGGTTTTTTTTTGTTTTGTTTTTTTTTTTTTTGGTTTTTTTTTTTTTTTTTTTTTTTTTTTTTTT
  TTTXTTTTTTTGGTTTGGGGGGTTTTGTTTTTTTTTTTTGGGTTTTTTTTTTTTTTTTTTTTTTTTTTTTTTTT
  TTTGTTTTTTTTGGGGGTTTTTTTTTGGGGGGGGGGGGGGTTTTTTTTTTTTTTTTTTTTTTTTTTTTTTTTTT
  TTTCTTTTTTTTTTTTTTTTTTTTTTTTTTTTTTTTTTTTTTTTTTTTTTTTTTTTTTTTTTTTTTTTTTTTTT