

  TTTTTTTTTTTTTTTTTTTTTTTTTTTTTTTTTTTTTTTTTTTTTTTTTTTTTTTTTTTTTTTTTTTTTTTTTT
  TTTTTTTGGGGGGGGGGGGGTTTTTTTTTGGGGTTTTGTTTTTTTTGGGGGGTTTTTRGGGGTTTTTGGGGPT
  TTTTTTTTTGGTTTTTTTTGGTTTTTTTTGGTTGGTTTGGGGGGGGGGTTTTGGTTTTTTTTGTTTTTGGHGGT
  TTTTTTTTTGGTTTTTTTTGGTTTTTTTGGTTTTGGTTGTTTTTTTTGTTTTGGGGGGGGGGGGGGGGGTTTTT
  TTTTTTTTTGGTTTTTTTTTGGGGGGGGGTTTTTTGGGGTTTTTTTTGGGGGGGTTTGTTTTTTTTTTTTTTTT
  TTTTTTTTTGGTTTTTTTTTTTTTTTTTGGGGGGGGTTTTTTTTTTTTTTTTTTTTTGTTTTTTTTTTTTTTTT
  TTTTTTTTTGGTTTTTTTTTTTTTTTTTTTTTGTTTTTTTTTTTTTTTTTTTTTTTTGGGGGGGGGCTTTTTTT
  TTTTIGGGGGGGGGGITTTTTTTTTTTTTTTTGTTTTTTTTTGGGGTTTTTTTTTTTTTTGTTTTTTTTTTTTT
  TTTTTTTTTGGTTTTTTTTGGGGGTTTTTTTTGTTTTTGGGGGTTTTTTTTTTTTTTTTTGTTTTTTTTTTTTT
  TTTGGGGGGGGTTTTTTTTGGGGGTTTTTTTTRTTTTTGGGGGGGGGGGTTTTTTTTTTTGTTTTTTTTTTTTT
  TTTGTTTTTRTTTTTTTTTGGGGGTTTTTTTTTTTGGGGGGGGTTTTTGGTTTTTTTTTTGTTTTTTTTTTTTT
  TTTGTTTTTTTTTTTTTTTTTTTTTTTTTTTTTGGGTTTTTTTTTTTTTGGTTTTTTTTTGTTTTTTTGGETTT
  TTTGTTTTTTTTTTTTTTTTTGGGGGGGGGGGGGTTTTTTTTTTTTTTTTGGTTTTTTTTGTTTTTTTGGGTTT
  TTTGTTTTTTTTTTTTTTTTTGTTTTTTTTTGTTTTTTTTTTTTTTTTTTGGTTTTTTTTGTTTTTTTGGGTTT
  TTTGGGGGGGGTTTTTTTTTTGTTTTTTTTTGTTTTTTTTTTTTGGRTTTTGGGTTTTTTGGGGGGGGGTTTTT
  TTTGTTTTTGGTTTTTTTTTTGTTTTGGGGGGTTTTTTTTTTGGGTTTTTTTTGGCTTTTTTTTTTTTTTTTTT
  TTTGTTTTTTGGTTTTTTTTTGTTTTGTTTTTTTTTTTTTTGGTTTTTTTTTTGGTTTTTTRTTTTTTTTTTTT
  TTTXTTTTTTTGGTTTGGGGGGTTTTGTTTTTTTTTTTTGGGTTTTTTTTTTTGGTTTTGGGTTTTTTTTTTTT
  TTTGTTTTTTTTGGGGGTTTTTTTTTGGGGGGGGGGGGGGTTTTTTTTTTTTTTGGGGGGGGTTTTTTTTTTTT
  TTTCTTTTTTTTTTTTTTTTTTTTTTTTTTTTTTTTTTTTTTTTTTTTTTTTTTTTTTTTTTTTTTTTTTTTTT