11111111111111111111111111111111111111111111111111111111111111111111111111
11GGGGGGGGGGGGGGGGGGGGGGGGGGGGGGGGGGGGGGGGGGGGCWWWGGGGGGGGGGGGGGGGGGGGGW11
11WWWGGGWWWWWWWWWWWWWWWGGWWWWWWWWWWWWWWWGGGGGWWWWWRWGGGGGWWWWGGGGGGGGGGW11
11CGGGGWWWWWWGRWWWWWWWWGWWWWWWWWWWWWWWWWWWWGGWWWWWWWGGWWWWWWWGWWWWWWWWGW11
11WWWGGGGGGGGGGWWWWWWWWCWWWWWWWWWWWWWWWWGGGGGGGGGGGGGGWWWWWWWGWWWWWWWWGW11
11WWWGGWWWWWWWWWWWWWWWWWWWWWWWWWWWWWWWWWRGWGGGGGGGGGGGWWWWWWWGWWWWWWWWGW11
11WWWWWWWWWWWWWWWWWWWWWWWWWWWWWWWWWWWWWWWWWWWWWWWWWGGGWWWWWWWGWWWWWWWWGW11
11WWWWWWWWWWWWWGGGWWWWWWWGGGGGGGGGGGGGGGGGGGGGGGGGGGGGWWWWWWWWWWWWWWWWGW11
11WWWWRGGGWWWWWGGGWWWWWWWGGGGGGGGGGGGGGGGGGGGGGGGGGGGGWWWWWWWWWWWWWWGGGW11
11WWWWWWGGGGWWWGGGGGGGWWWWGGGWWWWWWGWWWWWWWWWWWWWWWGGGWWWWWWWWWWWWWWWWGW11
11WWWWWWGGGGGGGGWWWGGGWWWWGGGWWWWWWGWWWWWWWWWWWWWWWGGGWWWWWWWGGGGGGGGGGW11
11WWWWWWWWWGGGGWWWWWGGWWWWGGGWWWWWWGGWWWWWWWWWGGGGGGGGWWWWWWWGWWWWWWWWWW11
11WWWWWWWWWWGGWWWWWWGGGGGGGGWWWWWWWWGGWWWWWWWWWWWWGWWWWWWWWWGGGWWWWWWPGW11
11WWWWWWWGGGGGWWWWWWWWWWGWWWWWWWWWWWWGWWWWWWWWWWWWGWWWWWWWWWGGGWWWWWWGHW11
11WWWWWWWWGGWWWWWWWWWWWWGWWWWWWWWWWWWGWWGRWWWWWWGGGWWWWWWWWWGGGWWWWGGGGW11
11WWWGGGGGGGGGGGGGWWWWWWGWWWWWWEWWWWWGWGGWWWWWWGGWGGGGGWWWWWGGGWWWWGGGGW11
11WWWGGGWWWWWWWWGGWWWWWWGCWWWWWXWWWGGGGGWWWWWWGGWWWWWWGWWWWWGGGGGGGGGGWW11
11WWWGGGGGGGWWWWGGWWWWWWWWWWWWWGGWWWWWGWWWWWWRGWWWWWWWGWWWWWGGGGGGGGGGGW11
11WWWRGWWWWWWWWWGGGGGGGGGGGGGGGGGWWWWWGGWWWWWWWWWWWWWGGWWWWWWWWWWWWWWWWW11
11111111111111111111111111111111111111111111111111111111111111111111111111