
  
  WWWWWWWWWWWWWWWWWWWWWWWWWWWWWWWWWWWWWWWWWWWWWWWWWWWWWWWWWWWWWWWWWWWWWWWWWW
  W     AAAAAAAAAAAAAAAAAAAA                   WWWWWAAAAAAAAAAAAAAAAAAAAAWWW
  WWWWWAAAWWWWWWWWWWWWWWWWWWWWWWWWWWWWWWWW  AAAWWWWWAAAAAAAAAAAAAAAAAAAAAWWW
  WWC  AAWWWWWW RWWWWWWWWWWWWWWWWWWWWWWWWW  AAAWWWWW    WWWWWWWWWWWWWW   WWW
  WWWWWAA        WWWWWWWWWWWWWWWWWWWWWWWWW  AAA         WWWWWWWWWWWWWW   WWW
  WWWWW  WWWWWWWWWWWWWWWWWWWWWWWWWWWWWWWWW              WWWWWWWWWWWWWW   WWW
  WWWWWWWWWWWWWWWWWWWWWWWWWWWWWWWWWWWWWWWWWWWWWWWWWWW   WWWWWW ARWWWWW   WWW
  WWWWWWWWWWWWWWW   WWWWWWW    AAAAAAAAAAAAAAAAAAAAAAAAAWWWWWW AAWWWWW   WWW
  WWWWWWR   WWWWW   WWWWWWW                             WWWWWW AAWWWWW   WWW
  WWWWWWWW    WWWAAAAAAAWWWW   WWWWWWWWWWWWWWWWWWWWWW   WWWWWW AA        WWW
  WWWWWWWW        WWW AAWWWW   WWWWWWWWWWWWWWWWWWWWWW   WWWWWW AA        WWW
  WWWWWWWWWWW    WWWWWA WWWW   WWWWWWWWWWWWWWWWW        WWWWWW AAWWWWWWWWWWW
  WWWWWWWWWWWW  WWWWWW        WWWWWWWWWWWWWWWWWWWWWW WWWWWWWWW AAWWWWWWP WWW
  WWWWWWWWW     WWWWWWWWWWWWWWWWWWWWWWWWWWWWWWWWWWWW WWWWWWWWW AAWWWWWW HWWW
  WWWWWWWWWW  WWWWWWWWWWWWWWWWWWWWWWWWWWWWWWWWWWWW   WWWWWWWWW AAWWWW    WWW
  WWWWW             WWWWWWWWWWWWWEWWWWWWWWWWWWWWW  W     WWWWW AAWWWW    WWW
  WWWWW   WWWWWWWW  WWWWWWWWWWWWWXWWWWWWWWWWWWWW  WWWWWW WWWWW          WWWW
  WWWWW       WWWW  WWWWWWWWWWWWW  WWWWWWWWWWWWR WWWWWWW WWWWW           WWW
  WWWWWR WWWWWWWWW                 WWWWWWWWWWWWWWWWWWWW  WWWWWWWWWWWWWWWWWWW
  WWWWWWWWWWWWWWWWWWWWWWWWWWWWWWWWWWWWWWWWWWWWWWWWWWWWWWWWWWWWWWWWWWWWWWWWWW