

WWWWWWWWWWWWWWWWWWWWWWWWWWWWWWWWWWWWWWWWWWWWWWWWWWWWWWWWWWWWWWWWWWWWWWWWWW
WGGGGGAAAAAAAAAAAAAAAAAAAAGGGGGGGGGGGGGGGGGGGWWWWWAAAAAAAAAAAAAAAAAAAAAWWW
WWWWWAAAWWWWWWWWWWWWWWWWWWWWWWWWWWWWWWWWGGAAAWWWWWAAAAAAAAAAAAAAAAAAAAAWWW
WWCGGAAWWWWWWGRWWWWWWWWWWWWWWWWWWWWWWWWWGGAAAWWWWWGGGGWWWWWWWWWWWWWWGGGWWW
WWWWWAAGGGGGGGGWWWWWWWWWWWWWWWWWWWWWWWWWGGAAAGGGGGGGGGWWWWWWWWWWWWWWGGGWWW
WWWWWGGWWWWWWWWWWWWWWWWWWWWWWWWWWWWWWWWWGGGGGGGGGGGGGGWWWWWWWWWWWWWWGGGWWW
WWWWWWWWWWWWWWWWWWWWWWWWWWWWWWWWWWWWWWWWWWWWWWWWWWWGGGWWWWWWGARWWWWWGGGWWW
WWWWWWWWWWWWWWWGGGWWWWWWWGGGGAAAAAAAAAAAAAAAAAAAAAAAAAWWWWWWGAAWWWWWGGGWWW
WWWWWWRGGGWWWWWGGGWWWWWWWGGGGGGGGGGGGGGGGGGGGGGGGGGGGGWWWWWWGAAWWWWWGGGWWW
WWWWWWWWGGGGWWWAAAAAAAWWWWGGGWWWWWWWWWWWWWWWWWWWWWWGGGWWWWWWGAAGGGGGGGGWWW
WWWWWWWWGGGGGGGGWWWGAAWWWWGGGWWWWWWWWWWWWWWWWWWWWWWGGGWWWWWWGAAGGGGGGGGWWW
WWWWWWWWWWWGGGGWWWWWAGWWWWGGGWWWWWWWWWWWWWWWWWGGGGGGGGWWWWWWGAAWWWWWWWWWWW
WWWWWWWWWWWWGGWWWWWWGGGGGGGGWWWWWWWWWWWWWWWWWWWWWWGWWWWWWWWWGAAWWWWWWPGWWW
WWWWWWWWWGGGGGWWWWWWWWWWWWWWWWWWWWWWWWWWWWWWWWWWWWGWWWWWWWWWGAAWWWWWWGHWWW
WWWWWWWWWWGGWWWWWWWWWWWWWWWWWWWWWWWWWWWWWWWWWWWWGGGWWWWWWWWWGAAWWWWGGGGWWW
WWWWWGGGGGGGGGGGGGWWWWWWWWWWWWWEWWWWWWWWWWWWWWWGGWGGGGGWWWWWGAAWWWWGGGGWWW
WWWWWGGGWWWWWWWWGGWWWWWWWWWWWWWXWWWWWWWWWWWWWWGGWWWWWWGWWWWWGGGGGGGGGGWWWW
WWWWWGGGGGGGWWWWGGWWWWWWWWWWWWWGGWWWWWWWWWWWWRGWWWWWWWGWWWWWGGGGGGGGGGGWWW
WWWWWRGWWWWWWWWWGGGGGGGGGGGGGGGGGWWWWWWWWWWWWWWWWWWWWGGWWWWWWWWWWWWWWWWWWW
WWWWWWWWWWWWWWWWWWWWWWWWWWWWWWWWWWWWWWWWWWWWWWWWWWWWWWWWWWWWWWWWWWWWWWWWWW