111111111111111111111111111111111111111111111111111111111111111111111111111111
11ZZZZZRZZZZZZZZRZZZZZZZZZZZZZZVVVVVVVVVVVZZZZZZZZZZZZZZZZZZZVVVVRZZZZZZZZZZ11
11ZZZZZVZZZZZZZVVZZZZZZVZZZVVVVVVZZZZZZZZVVVZZZZZZZZVVVVVVVVVVZZZZZZZZZZZZZZ11
11ZZZZZVZZZZZZVVZZZZZZZVZZZZZVVZZZZZZZZZZZZVVVVZZZZVVZZZZZZZZVZZZZZZZZZZZZZZ11
11ZZZZZVZZZZZZZVVZZZZZZVZZZZZZVVVZZZCZZZZZZZZZVVVVVVZZZZZZZZVVVZZZZZZZZZZZEZ11
11ZZZZVVVVVZZZZZVVVVVVVVZZZZZZZVVZZZVZZZZZVVVVVZZZZZZZZZZZZZVZZZZZZZZZZZZVVZ11
11ZZVVVZZZVVVZZZZVZZZZZVVZZZZZZVVZZZVZZZZZZZZZZZZZZZZZZZZZZZVZZZZZZZZZZZVVZZ11
11ZZVZZZZZZVVVVVVVZZZZVVZZZZZZZZVVVVVZZZZZZZZVRZZZZZZZZZZZZZVZZZZZZZZZZZXZZZ11
11ZZVZZZZZZZZZZZZZZZZVVVVZZZZZZZZZZZVZZZZZZZZVZZZZZZZZZZZZVVVZZZZZZZZZZZVZZZ11
11ZZVVVZZZZZZZZZZZZZZZZZVZZZZZZZZZZVVZZZZZZZVVZZZZZZZZZVVVVZZZZZZZZZZZZVVVZZ11
11ZZZZVZZZZZZZVCZZZZZZZZVZZZZZZZZZVVZZZZZZZVVZZZZZZZZVVVZZZZZZZZZZZZZZZVVVZZ11
11ZZZZVVZZZZZVVZZZZZZZZVVVZZZZZZZZZVVZZZZZZVVZZZZZZZVVZZZZZZZZZZZZZZZVVVZZZZ11
11ZZZZZVVVVVZVZZZZZZZZZZZVVRZZZZZZZVZZZZZVVVZZZZZZZVVZZZZZZZZZZZZZZVVVZZZZZZ11
11ZZZZZZZZZVVVZZZZZZZZZZVVZZZZZZZZZVVVVVVVZZZZZZZZVVZZZZZZZZZZZZZZZVZZZZZZZZ11
11ZZZVVVVVVVZZZZZZZZZZZZVVZZZZZZZZZZZVVVZZZZZZZZZZVZZZZZZZZZZZZZZZZVVVZZZZZZ11
11ZZZVZZZZVZZZVCZZZZZZZVVVZZZZZZZZZVVVZZZZZZZZZZZZVZZZZZZZZZZZZZZZZZVVVZZZZZ11
11ZZZVZZZVVVVVVZZZZZZZZZVVVZZZZZZZZZVZZZZZZZZZZZZZVVZZZZZVVVVVVVVVZZZZVZZZZZ11
11ZZZVZVVZVVZZZZZZZZZZZZZVVVVZZZZZZZVZZZZZZZZZZZZZZVVVZVVVVZZZZZVVVVVVVZZZZZ11
11ZZZVVVZZZVVZZZZZZZZZZZZZVVVVVVVVVVVZZZZZZZZZZZZZZZZVVVZZZZZZZZZZVVZZZZZZZZ11
11ZZZZZZZZZZVZZZZZZZZZZZZZZZZZZZZZZZZZZZZZZZZZZZZZZZZZZZZZZZZZZZZZZVZZZZZZZZ11
11ZZZZZZZZZHPZZZZZZZZZZZZZZZZZZZZZZZZZZZZZZZZZZZZZZZZZZZZZZZZZZZZZZVVCZZZZZZ11
111111111111111111111111111111111111111111111111111111111111111111111111111111