11111111111111111111111111111111111111111111111111111111111111111111111111
11WWWWWWWWWWWWWWWWWWWWWWWWWWWWWWWWWWWWWWWWWWWWWWWWWWWWWWWWWWWWWW     EWW11	
11WW                WWWWWWWWWW    WWWWWWWWWWWWWWWWWWWWWWWWWWWWWW WWWWWWW11
11WWW WWWWWWWW WWW  WWWWWWWWWW      WWWWWWWWWWWWWWWWWWWWWWWWWWWWXWWWWWWW11
11WWW WWWWWWWW WWW CWWWWWWWWWW WWWW  WWWWWWWWWWWWWWWWWWWWW       WWWWWWW11
11WWW WW       WWWWWWWWWWWWWWW WWWWWWWWWWWWWWWWWWWWWWWWWWW WW WWWWWWWWWW11
11WWW WW WWWWW                 WWWWWWWWWWWWWWWWWW   WWWWWW WW WWWWWWWWWW11
11WWW WWWWWWWWWWWWWWWWWWWWWWWW WWWWWWWWWWWWWWWWWW W WWWWWWWWW WWWWWWWWWW11
11WWW   WWWWWWWWWWWWWWWWWWWWWW WWWWWWWWWWWWWWWWW  W WWWWWWW   WWWWWWWWWW11
11WWWWW WWWWWWWWWWWWWWWWWWWWWW WWWWWWWWWWWWWWWWWW W WWWWW   WWWWWWWWWWWW11
11WWWWW WWWWWRWWWWWWWWWWWWWWWW WWWWWWWWWWWWWWWWW  W       WWWWWWWWWWWWWW11
11WWWWW WW       WWWWWWWWWWWWW       WWWWWWWWWWWW WWWWWWWWWWWWWWWWWWWWWW11
11WWWWW WW  WWW  WWWWWWWWWWWWWWW     WWWWWWWWWWW  WWWWWWWWWWWWWWWWWWWWWW11
11WWWWW     WWW  WWWWWWWWWWWWWWW     WWWWWWWWWWWW WWWWWWWWWWWWWWWWWWWWWW11
11WWWWWWWWWWWWW  WWWW     WWWWWW     WWWWWWWWWWWW WWWWWWWWWWWWWWWWWWWWWW11
11WWWWWWWWWWWWW  WWWWWWW  WWWWWWWWWW              WWWWWWWWWWWWWWWWWWWWWW11
11WWWWWWWWW               WWWWWWWWWWWWWWW WWW WWW WWWWWWWWWWWWWWWWWWWWWW11
11WWWWWWWWW HWWWWWWWWWWWWWWWWWWWWWWWWWWWW WWW WWW WWWWWWWWWWWWWWWWWWWWWW11
11WWWWWWWWW PWWWWWWWWWWWWWWWWWWWWWWWWWWWWCWWWCWWWRWWWWWWWWWWWWWWWWWWWWWW11
11111111111111111111111111111111111111111111111111111111111111111111111111