

  WWWWWWWWWWWWWWWWWWWWWWWWWWWWWWWWWWWWWWWWWWWWWWWWWWWWWWWWWWWWWWWWWWWWWWWWWW
  WWWWWWWWWWWWWWWWWWWWWWWWWWWWWWWWWWWWWWWWWWWWWWWWWWWWWWWWWWWWWWWW     EWWWW
  WWWW                WWWWWWWWWW    WWWWWWWWWWWWWWWWWWWWWWWWWWWWWW WWWWWWWWW
  WWWWW WWWWWWWW WWW  WWWWWWWWWW      WWWWWWWWWWWWWWWWWWWWWWWWWWWWXWWWWWWWWW
  WWWWW WWWWWWWW WWW CWWWWWWWWWW WWWW  WWWWWWWWWWWWWWWWWWWWW       WWWWWWWWW
  WWWWW WW       WWWWWWWWWWWWWWW WWWWWWWWWWWWWWWWWWWWWWWWWWW WW WWWWWWWWWWWW
  WWWWW WW WWWWW                 WWWWWWWWWWWWWWWWWW   WWWWWW WW WWWWWWWWWWWW
  WWWWW WWWWWWWWWWWWWWWWWWWWWWWW WWWWWWWWWWWWWWWWWW W WWWWWWWWW WWWWWWWWWWWW
  WWWWW   WWWWWWWWWWWWWWWWWWWWWW WWWWWWWWWWWWWWWWW  W WWWWWWW   WWWWWWWWWWWW
  WWWWWWW WWWWWWWWWWWWWWWWWWWWWW WWWWWWWWWWWWWWWWWW W WWWWW   WWWWWWWWWWWWWW
  WWWWWWW WWWWWRWWWWWWWWWWWWWWWW WWWWWWWWWWWWWWWWW  W       WWWWWWWWWWWWWWWW
  WWWWWWW WW       WWWWWWWWWWWWW       WWWWWWWWWWWW WWWWWWWWWWWWWWWWWWWWWWWW
  WWWWWWW WW  WWW  WWWWWWWWWWWWWWW     WWWWWWWWWWW  WWWWWWWWWWWWWWWWWWWWWWWW
  WWWWWWW     WWW  WWWWWWWWWWWWWWW     WWWWWWWWWWWW WWWWWWWWWWWWWWWWWWWWWWWW
  WWWWWWWWWWWWWWW  WWWW     WWWWWW     WWWWWWWWWWWW WWWWWWWWWWWWWWWWWWWWWWWW
  WWWWWWWWWWWWWWW  WWWWWWW  WWWWWWWWWW              WWWWWWWWWWWWWWWWWWWWWWWW
  WWWWWWWWWWW               WWWWWWWWWWWWWWW WWW WWW WWWWWWWWWWWWWWWWWWWWWWWW
  WWWWWWWWWWW HWWWWWWWWWWWWWWWWWWWWWWWWWWWW WWW WWW WWWWWWWWWWWWWWWWWWWWWWWW
  WWWWWWWWWWW PWWWWWWWWWWWWWWWWWWWWWWWWWWWWCWWWCWWWRWWWWWWWWWWWWWWWWWWWWWWWW
  WWWWWWWWWWWWWWWWWWWWWWWWWWWWWWWWWWWWWWWWWWWWWWWWWWWWWWWWWWWWWWWWWWWWWWWWWW