1111111111111111111111111111111111111111111111111111111111111111111111111111
11▓▓▓▓GGGGG▓▓▓▓▓▓G▓▓▓P▓▓▓▓H▓▓GGGGGC▓▓▓▓▓▓▓▓▓▓▓▓▓▓▓▓▓▓▓▓▓▓▓▓▓▓▓▓▓▓▓▓▓▓▓▓▓▓▓▓1
11▓▓▓▓GRRRG▓GGGGGG▓▓▓G▓▓▓▓G▓▓G▓▓▓▓▓▓▓▓▓▓▓▓▓▓▓▓▓▓▓▓▓▓▓▓▓▓▓▓▓▓▓▓▓▓▓▓▓▓▓▓▓▓▓▓▓1
11▓▓▓▓GRGCG▓▓▓▓▓▓G▓▓▓G▓▓▓▓G▓▓G▓▓▓▓▓▓▓▓▓▓▓▓▓▓▓▓▓▓▓▓GGGGGG▓GGGGGGGGGGGGGGGGGC1
11▓▓▓▓GRRRG▓▓▓▓▓▓GGGGGGGGGGG▓GGGGGGGGGGG▓▓▓▓▓▓▓▓▓▓G▓▓▓GGGGGG▓▓▓▓▓▓▓▓▓▓▓▓▓▓▓1
11▓▓▓▓GGGGG▓▓▓▓▓▓G▓▓▓G▓▓▓▓▓▓▓▓▓▓▓▓▓▓▓▓▓G▓▓▓▓▓▓▓▓▓▓G▓▓▓▓▓▓▓▓▓▓▓GGGGGGG╔════╗1
11▓▓▓▓▓▓G▓▓▓▓▓▓▓▓T▓▓▓G▓▓▓▓▓▓▓▓▓▓▓▓▓▓▓▓▓G▓▓▓▓▓▓▓▓▓▓G▓▓▓▓▓▓▓▓▓▓▓G▓▓▓▓▓G║GGGR║1
11▓▓▓▓▓▓G▓▓▓▓▓▓▓▓▓▓▓▓G▓▓▓▓▓▓▓▓▓▓▓▓▓▓▓▓GGG▓▓▓▓▓▓▓▓▓G▓▓▓▓▓▓▓▓▓▓▓G▓▓▓▓▓G║▓▓GG║1
11▓▓▓▓▓▓GGGGGGGGGGGGGGGGGGGGGGGGGGGGGGGGGGGGGGGGGGGGGGGGGGGGGGGGGGGGG▓GG▓G▓1
11▓▓▓▓▓▓▓▓▓▓▓▓▓▓▓▓G▓▓▓▓▓▓▓▓▓▓▓▓▓▓▓▓▓▓▓GGG▓▓▓▓▓▓▓▓▓▓▓▓▓▓▓▓▓▓▓G▓▓▓▓▓▓▓▓▓▓▓▓G▓1
11▓▓▓▓▓▓▓▓▓▓▓▓▓▓▓▓G▓▓▓▓▓▓▓▓▓▓▓▓▓▓▓▓▓▓▓▓G▓▓▓▓▓▓▓▓▓▓▓▓▓▓▓▓▓▓▓▓GGGGGGGGGGGGGGG1
11▓▓▓▓▓▓▓▓▓▓▓▓▓▓▓▓G▓▓▓▓▓▓▓▓▓▓▓▓▓▓▓▓▓▓▓▓▓▓▓▓▓▓▓▓▓▓▓▓▓▓▓▓▓▓▓▓▓G▓▓▓▓▓▓▓▓▓▓▓▓▓▓1
11▓GGGGGGGGGGGGGGGGGGGGGGGGGGGGGGGGGGGGGGGGGGGGGGGGGGGGGGGGGGGGGGGGGGGGGGGG1
11▓▓▓▓▓▓▓M▓▓▓▓▓▓▓▓▓╔══G══╦═══▓═══╦══G═╗▓╔══G══╦═══G═══╦══G═╗G▓▓▓▓▓▓▓▓▓▓▓▓▓▓1
11▓▓▓▓▓▓GGG▓▓▓▓▓▓▓▓║GGGGG║GGGGGGG║GGMG║▓║GGGGG║GGGGGGG║GGGG║G▓▓GGGGGGGGG▓▓▓1
11▓▓▓▓▓▓G▓G▓▓▓▓▓▓▓▓║GGGGG║GGGGGGGGGGGG║G║GGGGG║GGGGGGG║GGGG║G▓▓G▓▓▓▓▓▓▓G▓▓▓1
11▓▓▓▓▓▓C▓R▓▓▓▓▓▓▓▓║GGGGG║CGGGGGG║GGGG║X║GGGGC║GGGGGGR║GGGG║GGGG▓▓▓▓▓▓▓▄▓▓▓1
11▓▓▓▓▓▓▓▓▓▓▓▓▓▓▓▓▓▓▓▓▓▓▓▓▓▓▓▓▓▓▓▓▓▓▓▓▓▓▓▓▓▓▓▓▓▓▓▓▓▓▓▓▓▓▓▓▓▓▓▓▓▓▓▓▓▓▓▓▓▓▓▓▓1
11▓▓▓▓▓▓▓▓▓▓▓▓▓▓▓▓▓▓▓▓▓▓▓▓▓▓▓▓▓▓▓▓▓▓▓▓║E║▓▓▓▓▓▓▓▓▓▓▓▓▓▓▓▓▓▓▓▓▓▓▓▓▓▓▓▓▓▓▓▓▓▓1
1111111111111111111111111111111111111111111111111111111111111111111111111111