1111111111111111111111111111111111111111111111111111111111111111111111111111
11▓▓▓▓GGGGG▓▓▓▓▓▓G▓▓▓P▓▓▓▓H▓▓GGGGGC▓▓▓▓▓▓▓▓▓▓▓▓▓▓▓▓▓▓▓▓▓▓▓▓▓▓▓▓▓▓▓▓▓▓▓▓▓▓▓11
11▓▓▓▓GRRRG▓GGGGGG▓▓▓G▓▓▓▓G▓▓G▓▓▓▓▓▓▓▓▓▓▓▓▓▓▓▓▓▓▓▓▓▓▓▓▓▓▓▓▓▓▓▓▓▓▓▓▓▓▓▓▓▓▓▓11
11▓▓▓▓GRGCG▓▓▓▓▓▓G▓▓▓G▓▓▓▓G▓▓G▓▓▓▓▓▓▓▓▓▓▓▓▓▓▓▓▓▓▓▓GGGGGG▓GGGGGGGGGGGGGGGGC11
11▓▓▓▓GRRRG▓▓▓▓▓▓GGGGGGGGGGG▓GGGGGGGGGGG▓▓▓▓▓▓▓▓▓▓G▓▓▓GGGGGG▓▓▓▓▓▓▓▓▓▓▓▓▓▓11
11▓▓▓▓GGGGG▓▓▓▓▓▓G▓▓▓G▓▓▓▓▓▓▓▓▓▓▓▓▓▓▓▓▓G▓▓▓▓▓▓▓▓▓▓G▓▓▓▓▓▓▓▓▓▓▓GGGGGGGWWWWW11
11▓▓▓▓▓▓G▓▓▓▓▓▓▓▓T▓▓▓G▓▓▓▓▓▓▓▓▓▓▓▓▓▓▓▓▓G▓▓▓▓▓▓▓▓▓▓G▓▓▓▓▓▓▓▓▓▓▓G▓▓▓▓▓GWGGGR11
11▓▓▓▓▓▓G▓▓▓▓▓▓▓▓▓▓▓▓G▓▓▓▓▓▓▓▓▓▓▓▓▓▓▓▓GGG▓▓▓▓▓▓▓▓▓G▓▓▓▓▓▓▓▓▓▓▓G▓▓▓▓▓GW▓▓GG11
11▓▓▓▓▓▓GGGGGGGGGGGGGGGGGGGGGGGGGGGGGGGGGGGGGGGGGGGGGGGGGGGGGGGGGGGGG▓GG▓G11
11▓▓▓▓▓▓▓▓▓▓▓▓▓▓▓▓G▓▓▓▓▓▓▓▓▓▓▓▓▓▓▓▓▓▓▓GGG▓▓▓▓▓▓▓▓▓▓▓▓▓▓▓▓▓▓▓G▓▓▓▓▓▓▓▓▓▓▓▓G11
11▓▓▓▓▓▓▓▓▓▓▓▓▓▓▓▓G▓▓▓▓▓▓▓▓▓▓▓▓▓▓▓▓▓▓▓▓G▓▓▓▓▓▓▓▓▓▓▓▓▓▓▓▓▓▓▓▓GGGGGGGGGGGGGG11
11▓▓▓▓▓▓▓▓▓▓▓▓▓▓▓▓G▓▓▓▓▓▓▓▓▓▓▓▓▓▓▓▓▓▓▓▓▓▓▓▓▓▓▓▓▓▓▓▓▓▓▓▓▓▓▓▓▓G▓▓▓▓▓▓▓▓▓▓▓▓▓11
11▓GGGGGGGGGGGGGGGGGGGGGGGGGGGGGGGGGGGGGGGGGGGGGGGGGGGGGGGGGGGGGGGGGGGGGGG11
11▓▓▓▓▓▓▓G▓▓▓▓▓▓▓▓▓WWWGWWWWWW▓WWWWWWGWWGWWWGWWWWWWGWWWWWWGWWG▓▓▓▓▓▓▓▓▓▓▓▓▓11
11▓▓▓▓▓▓GGG▓▓▓▓▓▓▓▓WGGGGGWWWWWWWWWGGMGWGWGGGGGWGGGGGGGWGGGGWG▓▓GGGGGGGGG▓▓11
11▓▓▓▓▓▓G▓G▓▓▓▓▓▓▓▓WGGGGGWGGGGGGGGGGGGWGWGGGGGWGGGGGGGWGGGGWG▓▓G▓▓▓▓▓▓▓G▓▓11
11▓▓▓▓▓▓C▓R▓▓▓▓▓▓▓▓WWWWWWWWWWWWWWWWWWWWGWWWWWWWWWWWWWWWWWWWWWW▓▓▓▓▓▓▓▓▓▓▓▓11
11▓▓▓▓▓▓▓▓▓▓▓▓▓▓▓▓▓▓▓▓▓▓▓▓▓▓▓▓▓▓▓▓▓▓▓▓WEW▓▓▓▓▓▓▓▓▓▓▓▓▓▓▓▓▓▓▓▓▓▓▓▓▓▓▓▓▓▓▓▓▓11
1111111111111111111111111111111111111111111111111111111111111111111111111111