/=============================================================================\
¦                                                                             ¦
¦                                                                             ¦
¦                                                                             ¦
¦                                                                             ¦
¦                                                                             ¦
¦                                                                             ¦
¦                                                                             ¦
¦                                                                             ¦
¦                                                                             ¦
¦                                                                             ¦
¦                                                                             ¦
¦                                                                             ¦
¦                                                                             ¦
¦                                                                             ¦
¦                                                                             ¦
¦                                                                             ¦
¦                                                                             ¦
¦                                                                             ¦
¦                                                                             ¦
¦                                                                             ¦
¦                                                                             ¦
¦                                                                             ¦
¦                                                                             ¦
¦                                                                             ¦
¦                                                                             ¦
¦                                                                             ¦
\=============================================================================/